###.####0#
###.###21#
##.####34#
#.###765##
.###98####
