##.##0#
##.#21#
####34#
##8765#
#######
